XOXOOXOOXO
OOXOXOOOOO
XOOOOOXOOO
OXOOXOXXXX
OOXOXOOOOO
OOXOOOOXXO
OOXOOOOXOO
XOOOOOXOXX
XXOOXOOOXX